abregé	VER:ppre	abréger
absolumens	ADV	absolument
adultere	NOM	adultère
affoiblies	VER:pper	affaiblir
affoiblir	VER:infi	affaiblir
affoibliroient	VER:impe	affaiblir
aisement	ADV	aisément
ajoûtons	VER:pres	ajouter
anéantiroit	VER:cond	anéantir
auroient	VER:impe	avoir
aurois	VER:impe	avoir
aussi-tôt	ADV	aussitôt
avois	VER:impe	avoir
avoit	VER:impe	avoir
barrieres	NOM	barrière
bienfaisans	ADJ	bienfaisant
cahos	NOM	chaos
chargeroient	VER:cond	charger
châtimens	NOM	châtiment
chimere	NOM	chimère
connoissance	NOM	connaissance
connoissent	VER:pres	connaître
connoit	VER:pres	connaître
consequence	NOM	conséquence
consoleroient	VER:cond	consoler
croiroient	VER:impe	croire
croiroit	VER:cond	croire
croisoient	VER:impe	croiser
desirer	VER:infi	désirer
desirs	NOM	désir
devenoient	VER:impe	devenir
devenoit	VER:impe	devenir
devoient	VER:impe	devoir
devroient	VER:cond	devoir
differe	VER:pres	différer
différe	VER:pres	différer
différens	ADJ	différent
dirois	VER:impe	dire
diviseroient	VER:cond	diviser
diviseroit	VER:cond	diviser
donnerent	VER:simp	donner
dûrent	VER:simp	durer
éleve	VER:pres	élever
entens	VER:pres	entendre
especes	NOM	espèce
estimerois	VER:cond	estimer
étois	VER:impe	être
étoit	VER:impe	être
éxige	VER:pres	exiger
falloit	VER:impe	falloir
faudroit	VER:cond	falloir
foible	ADJ	faible
foibles	ADJ	faible
foiblesse	NOM	faiblesse
fondemens	NOM	fondement
formerent	VER:simp	former
fréquens	ADJ	fréquent
funebres	ADJ	funèbre
gémissemens	NOM	gémissement
guere	ADV	guère
guères	ADV	guère
importans	ADJ	important
indépendans	ADJ	indépendant
ineffacables	ADJ	ineffaçable
intérèt	NOM	intérêt
jetteroient	VER:cond	jeter
jugemens	NOM	jugement
loix	NOM	loi
long-temps	ADV	longtemps
longtems	ADV	longtemps
matiere	NOM	matière
méchanique	NOM	mécanique
montrerois	VER:cond	montrer
mouvemens	NOM	mouvement
nècessité	NOM	nécessité
offroit	VER:impe	offrir
oublioient	VER:impe	oublier
parlois	VER:impe	parler
paroissent	VER:pres	paraître
paroîtra	VER:futu	paraître
particulieres	ADJ	particulier
pénetré	VER:pper	pénétrer
plûpart	NOM	plupart
pourroit	VER:impe	pouvoir
pouvois	VER:impe	pouvoir
pouvoit	VER:impe	pouvoir
preceptes	NOM	précepte
préféreroit	VER:cond	préférer
présens	ADJ	présent
prèt	ADJ	prêt
prétens	VER:pres	prétendre
puissans	ADJ	puissant
rameneroient	VER:cond	ramener
récens	ADJ	récent
reconnoissance	NOM	reconnaissance
reconnoître	VER:infi	reconnaître
recuser	VER:infi	récuser
réglemens	NOM	règlement
rejetter	VER:infi	rejeter
remercîmens	NOM	remerciement
rendoit	VER:impe	rendre
sacrifierent	VER:simp	sacrifier
sauroit	VER:cond	savoir
sçauront	VER:futu	savoir
sçavoit	VER:impe	savoir
secrette	ADJ	secret
secrettement	ADV	secrètement
sentimens	NOM	sentiment
seroient	VER:cond	être
seroit	VER:cond	être
sévérement	ADV	sévèrement
séveres	ADJ	sévère
siecles	NOM	siècle
soupcon	NOM	soupçon
soupconne	VER:pres	soupçonner
suffisans	ADJ	suffisant
suffisoit	VER:impe	suffire
systême	NOM	système
tems	NOM	temps
tendroit	VER:impe	tendre
théorême	NOM	théorème
tourmens	NOM	tourment
trouvoit	VER:impe	trouver
verroit	VER:cond	voir
voudroit	VER:impe	vouloir
vû	VER:ppre	voir
vûe	NOM	vue
zele	NOM	zèle
