conghietture	NOM	congeturra
adulterj	NOM	adulterio
vecchiaja	NOM	vecchiaia
matrimonj	NOM	matrimonio
proprj	ADJ	proprio
contradizione	NOM	contraddizione
secretamente	ADV	segretamente
testimonj	NOM	testimonio
vizj	NOM	vizio
ereditarj	NOM	ereditario
pregiudizj	NOM	pregiudizio
conjugale	ADJ	coniugale
proprii	ADJ	proprio
ereditarii	NOM	ereditario
matrimonii	NOM	matrimonio
vizii	NOM	vizio
giudizj	NOM	giudizio
indizj	NOM	indizio
richiedesi	VER:cimp	richiedere
escluder	VER:infi	escludere
indizii	NOM	indizio
esser	VER:infi	essere
resultato	NOM	risultato
studj	NOM	studio
conssessogli	NOM	concessogli
